TILE_TYPES_BEGIN
{'0': {'name': 'Air', 'file_path': '', 'alt_r': 255, 'alt_g': 0, 'alt_b': 0}, '1': {'name': 'Stone', 'file_path': '/Users/fabienschneider/Downloads/slack_profil_bild.jpg', 'alt_r': 0, 'alt_g': 255, 'alt_b': 0}, '2': {'name': 'Wood', 'file_path': '', 'alt_r': 0, 'alt_g': 0, 'alt_b': 255}}
TILE_TYPES_END

TILE_SIZE_BEGIN
25
TILE_SIZE_END

LAYOUT_BEGIN
0000000000000000000000000
0000000000000000000000000
0000000000000000000000000
0000000000000000000000000
0000000000000000000000000
0000000000000000000000000
0000000000000000000000000
0000000000000000000000000
0000000000000010000000000
0000000000000111000000000
0000000000011001100000000
0000000000110000100000000
0000000000100000100000000
0000000001000000100000000
0000000011000000100000000
0000000010000000100000000
0000000010000000100000000
0000000010000000100000000
0000000011000001000000000
0000000001100110000000000
0000000000111100000000000
0000000000000000000000000
0000000000000000000000000
0000000000000000000000000
0000000000000000000000000
LAYOUT_END
